R 700 500
NO textures/bluestone.xpm
SO textures/eagle.xpm

WE textures/purplestone.xpm

S textures/barril.xpm
F 140,0,230
C 0, 0, 0




			EA textures/wood.xpm

		11111 111111111111
		1E001 100000000001
		11101 100011111101
		11101110011    101
		110000000001111101
		100001110000000001
		100001110200002001
		111000000000000011
		   1111111111111
