R 700 500
NO textures/bluestone.xpm
SO textures/eagle.xpm

WE textures/purplestone.xpm
EA textures/wood.xpm

S textures/barril.xpm
F 220,100,30
C 225, 30, 10

	111111111111111111111111111111111111
	100000000001000100000020001000000001
	101011110111011100111000100011111101
	101000000010000000000010101000000101
	101011010010111111111110001000000121
	100001010010100S00000000101000000101
	101101010010101110101111101011111101
	100000010000000000002000000000000001
	101011110010111011111011111110011111
	100000000000001000000000000000000021
	111111111111111111111111111111111111
